####################
##......##........##
##.####.##.######.##
##.###..##.###....##
S..##..###.###.#####
#####.####.###....##
#####......######.##
#################..#
##################.E
####################
